#################                                    ###;
#...............#                                    #.#;
#...............#                                    #.#;
##############..#                                    #.#;
             #..#                                    #.#;
             #..#                                    #.#;
             #..#                                    #.#;
             #..#          ############              #.#;
             #..#          #..........#              #.#;
             #..#          #..........################.###;
             #..############.............................#;
             #........................####################;
             ###############..........#;
                           #..........#                                          ####################################################;
                           #..........#                                          #..................................................#;
                           ######..####                                          #..................................................#;
                                #..#                                             #..................................................#;
                                #..#       ############                          #..................................................#;
                                #..#       #..........#                          #..................................................#;
                                #..#       #..........############################..................................................#;
                                #..#       #........................................................................................#;
                                #..#########........................................................................................#;
                                #...................................................................................................#;
                                ############........................................................................................#;
                                           #..........############################..................................................#;
                                           #..........#                          #..................................................#;
                                           #..........#                          #..................................................#;
                                           ############                          #..................................................#;
                                                                                 #..................................................#;
                                                                                 #..................................................#;
                                                                                 ####################################################;